11111111111111111111
11111111111111111111
11111111111111111111
11111111111111111111
11111111111111111111
11111111111111111111
11111110111000111111
11111100010001111111
11111100000001111111
11111110000000111111
11111110000000111111
11111111000000111111
11111110000000111111
11111111000011111111
11111111111111111111
11111111111111111111
11111111111111111111
11111111111111111111
11111111111111111111
11111111111111111111
