11111111111111111111
11000011001010000011
11100011000000100011
11000000000000000111
11100011000000010011
11011100000010000011
11000001100010100011
11010000000000000011
11011000000000001111
11100000000000001111
11100001110000000111
11011110000111000011
11100000000111000011
11110000000000000011
11111000000100000011
11110000000100000011
11110000010100000011
11000000101110001011
11000001111111100111
11111111111111111111
