11111111111111111111
11111111111111111111
11111100111111111111
11100000011111111111
11100000011111111111
11100100001111111111
11100110011111111111
11111111111111111111
11111111111111111111
11111110100011111111
11111110000011111111
11111110000011111111
11111110000011111111
11111111111111111111
11111111000111111111
11111100000001111111
11111000000001111111
11111000000001111111
11111000110001111111
11111111111111111111
